C
...................
.........****......
#####..............
...####.....##**...
......####.........
.........***.. ....
.###....#####......
......x....##......
........####.......
..***..##..........
......***....***...
.**..###...##.#....
...................
...... ...**###....
...##........ .....
...................
.. ...***..........
......... .........
......###... *** ..
...................
..***..............
.......*.*###......
....*****..........
.***...............
.....***...........
... ..... ..***....
...................
..***.......#######
..........*###.....
.####...****.......
...............@...
...................