.*****.............
**........ ........
..**............. .
.... ... .....###..
..........####**...
..###....#####.....
...Q...............
##.. .##.***..*....
#......***.....  ..
..####..........###
..... ......###....
*.......###.... ...
............ ......
..***.####.......##
.*****......... **.
...**.*###.........
.....###.... *..  .
.#####.....**.. ...
.****.......###....
.. ....****....###.
...... ....#####...
...................
.####.**.....###...
.****...........###
..#**.......#####..
...................
.####..####.####...
..###...*****......
....****...###.....
..*. ...@...#####..
..........#####....
...................