...................
...............***.
..***.......  .....
...................
...................
......*#*..........
.....####..........
.**...#............
.....#........**...
.....#.............
.....########......
.@......*#*........
..... ..*#*........
........*#*..#*....
.**.....*#*........
........*#*.***....
........*#####.....
........*****#.....
.. .........*#.....
............*#.....
.... .....####.....
.............#.....
.. ..........#...x.
...........####....
....#########......
....#..............
....#*****.... ....
....###............
.......#...... ....
...................
.*****.....***#####
...................
