...................
..***.....###......
*...**.......**....
..x........***.....
....####..*#*......
.......#........ ..
###....#...........
..##........*......
.....***...........
.......*.*..*......
.####.......##.....
.......####........
..####.......**....
....#####..........
.......##... ... ..
.. ....##..........
... ....###**......
....#####..........
... ##....... .....
....##.............
.....###....#####..
####..**..***......
.............*****.
..#*..####....####.
...................
.......#########...
.##.###............
....*..**.###......
.##....##.....##...
....###........@...
..###...##**##.....
...................
