A
...................
...............***.
..***.......  .....
...................
.....#########.....
......*#*..........
.....####..... ....
.**...#............
.....#........**...
.....#.............
.....########......
.@......*#*........
..... ..*#*........
........*#*..#*....
.**.....*#*........
........*#*.***....
........*#####...x.
........*****#.....
.. .........*#.....
............*#.....
.... .....####.....
.............#.....
.. ..........#.....
...........####....
....#########......
....#..............
....#*****.... ....
....####...........
.......#...... ....
.......###.........
.*****.....***#####
...................
