B
...................
####...............
.................##
.......###*###.....
..........###..@...
...........##*##...
..#####..**.##.....
####........**.....
......##*.##.**....
............. .....
..##..##.***.... ..
...................
......#######......
...........#####...
####...............
.**...***. ... ..**
.#####.............
....######.........
.####.....****.....
.##............ ...
###.....****.......
..####.......*****.
****.....*****.....
###.........###....
...###.....######..
...................
......##.###.......
##....x.....#####..
......***..........
.... . ....***.....
..############.....
...................