...................
..***.....###......
*...**.......**....
...........***.....
....####..*#*......
.......#...........
###....#.......x...
..##........*......
.....***...........
.......*.*..*......
.####.......##.....
.......####........
..####.......**....
....#####..........
.......##..........
.......##..........
........###**......
....#####..........
... ##.........x...
....##.............
.....###....#####..
####..**..***......
.............*****.
..#*..####....####.
...................
.......#########...
.##.###............
....*..**.###......
.##....##.....##...
....###........@...
..###...##**##.....
...................
